100000000000000000000000000000000000
100000000000000000000000000000000000
100000000000000000000000000000000000
100000000000000000001111111111111110
100000000000000000111111111111111110
100P0000===0011111111111111111111110
111111111111111111111111111111111110