00000000000000000000000000000000
00000000000000000000000000000000
00000000000000000000000000000000
00000000000000000000000000000000
00000P00000000000000000000000000
00000000000==1111111111110000000
11111111111111111111111111111111