10000000000000000000000000000001
10000000000000000000000000000001
10000000000000000000000000000111
10000000000000000000111111111111
10000000000000000011111111111111
100P0000===001111111111111111111
11111111111111111111111111111111