2222222222222222200000000000000000
2222222222222222200000000000000000
2265555555555722200000000000000000
2230000000000422200000000000000000
223P0aaa0b000000000000000000000000
2281111111111922222222222222222222
2222222222222222222222222222222222
2222222222222222222222222222222222