22222222222222222
22222222222222222
22655555555557222
22300000000004222
223P0aaa0b0000022
22811111111119222
22222222222222222
22222222222222222